schedule	ticket
schedule	tickets
concert	tickets
concert	ticket
concerts	tickets
concerts	ticket
gmc	chevrolet
trucks	silverado
rv	camper
truck	car
car	truck
websites	software
website	software
shower	bathroom
sink	bathroom
sink	faucets
symptom	treatment
symptoms	treatment
faucets	sinks
tour	tickets
tub	bathroom
bath	bathroom
bathtub	bathroom
vanity	bathroom
faucet	shower
plumbing	faucets
training	classes
classes	training
poly	plastic
pvc	plastic
resin	plastic
vinyl	plastic
cable	internet
bisacodyl	dulcolax
footwear	boots
boots	shoes
jazz	ballet
wedding	bridal
formals	dresses
gowens	dresses
gown	dresses
dresses	clothing
sofas	furniture
sofa	furniture
deskjet	printer
eprint	printer
photosmart	printer
bride	groom
patio	outdoor
application	online
beachwear	swimwear
coupon	promo
buy	used
tracking	freight
freight	shipping
shipment	freight
ground	freight
ground	shipping
loan	financing
loans	financing
beach	vacation
tins	containers
jars	containers
cans	containers
packaging	containers
favors	suppliers
cheap	wholesale
cheapest	wholesale
order	personal
ordering	personal
bank	personal
packaging	container
fish	salmon
live	online
live	channels
online	channels
online	internet
xfinity	comcast
comcast	xfinity
home	house
home	houses
house	home
house	homes
homes	house
homes	houses
houses	home
houses	homes
replacement	repair
teflon	ptfe
dui	driving
cabin	vacation
shade	blind
shade	blinds
deals	decals
trucks	carts
carts	trucks
mapping	mapping software
map	map software
conveyors	conveyor belt
conveyor	conveyor belt
bag	backpacks
code	coupons
bookstore	textbooks
closeouts	clearance
printed	promotional
resort	hotels
trolley	transportation
trucking	transportation
hilton	hotel
hilton	hotels
motel	hotel
motel	hotels
associates	specialists
ticket	ticketmaster
intern	international
reasonable	affordable
student	university
plastic	plexiglass
screens	enclosures
poster	prints
poster	print
hotels	resort
appetizers	recipes
appetizer	recipe
decorating	design
decorating	designs
pneumococcal	pneumovax
home	homeowners
sierra	silverado
alcohol	drug
dwi	dui
fundraisers	fundraising ideas
senior	citizens
seniors	citizens
antique	vintage
lamps	lantern
touch	touchscreen
international	intercontinental
containers	box
desktop	computer
iphone	ipad
rebuild	repair
restoration	repair
mowers	morrow
trigreen	try green
lawnmowers	lawn
lawnmowers	lawns
trugrow	true
wedding	sodding
beachfront	oceanfront
computer	compare
company	compare
lacrosse	lax
brass	bronze
medicare	medicaid
stairway	stair lifts
stairway	stair lift
coupons	coupon codes
playground	playground equipment
playground	play equipment
playgrounds	playground equipment
playgrounds	play equipment
carcinoma	cancer
refinishing	restoration
medicaid	medicare
phone	iphone
phones	iphone
law	lawyer
law	lawyers
electric	electrician
electrical	electrician
electricity	electrician
vanity	avanity
renovation	construction
renovations	construction