ocean	oceanfront
watch	swatch
watch	swatches
watch	swatchs
watches	swatch
watches	swatches
watches	swatchs
suv	cuv
suvs	cuvs
suv	cuvs
suvs	cuv
holder	folder
holder	folders
holders	folders
shop	shoe
shop	shoes
shops	shoes
shops	shoe
line	online
sear	dear
sear	seater
sear	seat
does	dose
cloud	icloud
icloud	cloud
nurse	course
nurse	courses
nurses	courses
valid	invalid
invalid	valid
are	area
are	share
are	shares
contract	contact
contract	contacts
contracts	contact
contracts	contacts
holder	sholder
holders	sholders
invention	inventory
gmai	email
chain	chainsaw
chain	chainsaws
vintage	antique
construction	consulting
slippers	slides
slippers	clippers
slipper	clipper
slippers	skipper
slippers	zippers
hotels	motels
rental	tenant
virus	antivirus
parents	prints
data	date
ever	never
ever	even
rules	laws
shapers	shapewear
foot	food
docks	socks
our	hour
our	pour
our	your
our	tour
our	succour
our	four
book	ebook
bake	brake
bake	cake
radio	xmradio
radios	xmradio
lowers	flowers
lowers	lovers
lowers	mowers
socket	set
there	here
there	brothers
there	ethereum
there	the
there	theatre
there	theatres
there	then
there	thera
there	therese
there	therme
babylist	babyliss
the company	thefruitcompany
sika	sikabond
sika	sikadur
sika	sikaflex
sika	sikafloor
star	onstar
blood	bloom
blood	blook
audio	audiobook
state	estate
rental	dental
departments	apartments
department	apartment
departments	apartment
department	apartments
external	internal
this	his
this	thin
does	toes
motel	hotel
motels	hotels
motels	hotel
motel	hotels
sample	example
mail	email
mail	gmail
mail	imail
mail	nail
watch	iwatch
watch	ewatch
this	things
here	where
here	her
here	hero
example	exam
book	bookcase
book	booklet
book	chromebook
near	cleaners
near	mear
hotest	hotels
lock	locksmith
chains	inch
phone	thephonehouse
sing	single
sing	sink
sing	swing
lend	lens
lender	lander
lender	blender
lender	lenser
screw	crew
screw	screwdriver
screw	screwdrivers
canner	scanner
matoon	maroon
bank	bang
fur	four
fur	faur
vaccine	vaccination in
vaccine	vaccinations in
vaccines	vaccinations in
vaccines	vaccination in
course	coarse
homes	gomes
homes	homea
homes	homed
homes	jomes
homes	renttoownhomes
houses	hose
houses	hoses
houses	housrs
houses	hiuses
houses	hoises
houses	hpuses
tax	taxi
ank	tank
ank	bank
mouth	mouthwash
theme	tee
oi	online
2018	2017
scale	sales
chops	shop
chops	shops
chop	shop
chop	shops
witches	witchcraft
take	make
taking	making
boy	toy
boys	toys
mdx	rdx
mattress	imattress
maldives	male
n	network
bark	dark
stay	stat
work	workwear
tables	tablet
table	tablet
tables	tablets
table	tablets
offline	online
swimsuits	suit
under	underfloor
airguns	guns
bedliner	liner
face	facelift
spreads	bedspreads
tab	tablet
dive	drive
knit	knitwear
lemonade	lemon
racecourse	race
shirtwaist	shirt
finders	rangefinders
sc	search
blueshield	shield
photos	photoshoot
wrist	wristbands
mingle	single
residential	rent
cutout	cut
nc	nyc
beer	beverage
rice	price
saws	chainsaws
that	hat
card	car
blackboard	chalkboard
pot	teapot
tea	teapot
stock	cardstock
warming	housewarming
chainsaw	saw
mouth	mouthguard
sportswear	wear
tax	tx
cake	cupcakes
dancer	dancewear
clownfish	fish
earbuds	ears
setup	set
band	bandsaw
free	fre
onlinebanking	online
siberian	trans-siberian
bride	bridesmaids
empires	forgeofempires
store	bathstore
co	company
lakeridge	ridge
milkweed	weed
foldable	affordable
opentable	table
loop	hoop
river	riverfront
video	videography
allpower	power
cake	bakery
exxonmobil	mobil
water	waterpark
key	keyless
buttermilk	butter
horseware	horse
blinds	binds
fedexfield	field
fireplace	place
information	it
lift	forklift
sandbox	sand
bug	bedbug
bodysuit	suit
bunk	bunkbed
bunk	bunkbeds
help	helpline
korea	ondemandkorea
template	tee
flax	flaxseed
mail	mailboxes
simplemobile	mobile
sweatshirt	sweat
baggage	luggage
ca	contact
pizza	pizzeria
pizzeria	pizza
bootcut	boot
buds	earbuds
prepaid	paid
sweat	sweatpants
terrain	ta
using	business
actions	auctions
swim	swimsuits
pit	firepit
vine	vineyard
bonds	bondsman
charbroil	char
antimalware	malware
forklift	fork
della	del
soft	software
apart	apartment
scrap	scrapbook
sle	sale
checkup	check
sets	sheets
sheets	sets
headlight	light
spotlights	lights
books	bookstore
bookstore	books
cow	cowboy
beehive	bee
pinterest	interior
doorbell	door
bandsaw	saw
display	displayport
displayport	display
pillowcases	pillow
saw	bandsaw
free	freeware
wallpaper	wall
blackout	out
paper	wallpaper
set	sheets
bread	breadmaker
chalk	chalkboards
affordabletours	tours
barrow	barrel
coraline	online
motorbike	motor
set	sheet
pet	freshpet
saw	sawmill
sweatshirts	sweat
ticks	tickets
supercar	car
voi	voip
waterslide	water
barn	barnwood
rentalin	rental
bootcut	cut
hoverboard	board
cashback	back
sawblade	saw
sweatpants	pants
whitefish	fish
il	italian
java	javascript
rack	rackmount
shirt	sweatshirt
sweatshirt	shirt
waterproofing	water
drywall	wall
powerlift	lift
staircase	stairs
bedside	side
bigfarm	farm
onlinebanking	banking
signs	signage
smartwatch	watch
fare	airfare
foto	photo
kid	kindergarten
neck	v-neck
ny	nyack
nyack	ny
tx	texarkana
ballerina	ballet
framework	frame
logger	datalogger
sugarless	sugar
lawn	lawnmower
pillowcases	pillows
mets	tickets
lamps	lampshades
rvtrader	trader
work	workplace
cardstock	card
invest	in
paddleboard	board
authorization	authentication
fob	keyfob
sweatsuit	sweat
sports	sportswear
sportswear	sports
textbooks	text
waste	wastewater
cycle	motorcycle
fall	waterfall
food	good
good	food
photosmart	photo
pillowcase	pillows
yourhome	your
clues	blues
counters	countertop
cracker	nutcracker
photographers	photos
abcmouse	mouse
bath	bathtubs
ubereats	eats
bath	bathtub
bathrooms	bath
bathtub	bath
nose	noise
toes	shoes
mn	mankato
nc	nice
ticketsatwork	tickets
cheesecake	cheese
sendgrid	send
treestands	tree
beets	benefits
cart	car
pans	saucepans
oilprice	oil
nightgown	gown
learning	e-learning
wood	woodwork
windproof	wind
cutout	out
why	wy
bulkhead	bulk
hairspray	spray
health	healthcare
healthcare	health
id	idaho
loaf	meatloaf
meatloaf	loaf
slaw	coleslaw
muffs	earmuffs
tie	tire
antifungal	fungal
fb	football
tabletop	top
cell	sell
foodservice	foods
labrador	lab
pantsuit	pants
play	playset
whiplash	lash
mcgraw	graw
rangefinder	finder
va	veterans
va	virginia
mill	sawmill
paddleboard	paddle
cpap	pap
deer	dee
sign	signage
signage	sign
story	store
there	tee
back	backup
maryland	and
shades	lampshades
speedtest	test
brewers	beer
handbags	bags
news	newsletter
recent	center
springhill	spring
shirts	sweatshirts
stove	stovetop
turtleneck	tee
sweatshirts	shirts
dee	deep
barstool	stool
cash	cashback
theater	the
el	especiales
psychotherapy	therapy
pta	pa
spencer	marksandspencer
tablecloth	cloth
checklist	check
dentatrust	dental
usbank	bank
printouts	prints
showtimes	times
men	menswear
over	overnight
swim	swimwear
you	youth
osu	ou
ou	osu
second	secondhand
gerald	ga
wristbands	bands
shock	sock
sc	services
townhouses	houses
bluecrossblueshield	shield
some	women
bulb	lightbulb
grape	grapefruit
treehouse	tree
contested	uncontested
keller	sell
resale	sales
toothbrush	tooth
ink	inkjet
recoating	coating
sand	and
gaming	gambling
s	security
chime	windchime
fryer	airfryer
suit	swimsuit
dramafire	kdrama
dreams	edreams
pay	payroll
payroll	pay
play	playhouse
sights	sightseeing
hazelnut	nut
mango	man
raincoats	coats
rest	restaurant
del	delivery
lane	ln
looking	lookup
tablecloth	table
witch	switch
bag	mybag
emortgage	mortgage
mmo	mmorpg
sportswear	sport
shoecarnival	shoe
ca	cheap
tate	estate
creditcard	credit
creditcard	card
troubleshooting	trouble
troubleshooting	troubles
troubleshooting	shoot
nashua	nh
sweats	sweatshirt
autolist	autos
mower	lawnmower
cornbread	corn
sc	service
tooth	toothache
makeup	make
makeup	up
dealerportal	dealer
dealerportal	portal
watchfree	watch
watchfree	free
pickleball	pickle
pickleball	ball
atv	superatv
inc	finance
va	vacation
youtube	youtubetv
golf	golfnow
men	womens
with	without
shirt	tshirt
open	opentable
va	veteran
shirts	tshirt
adhd	add
compensation	comp
shirt	t-shirts
shake	shakeology
shield	blueshield
glasses	sunglasses
fort	ft
desktop	desk
saw	chainsaw
uber	ubereats
shirts	t-shirt
trip	roundtrip
under	underwear
nonprofit	profit
snowblower	snow
night	nightstand
nail	nailpolish
pre	preowned
snow	snowmobile
stove	stovetops
sheets	set
backup	back
testosterone	test
scope	microscope
glass	glassware
nh	nashua
it	information
it	informatique
it	intralot
it	iyt
it	ict
it	informatica
it	iot
it	irt
robes	bathrobes
make	makeup
townhomes	town
toothbrush	brush
tablecloths	table
stoves	stovetops
rear	repair
room	roommate
sleep	sleepwear
vegan	vegetarian
bookstore	store
stools	barstools
bullet	nutribullet
cybersecurity	security
screen	touchscreen
hypothyroidism	thyroid
whole	wholesale
wear	workwear
fares	airfares
sweatshirts	shirt
co	clothing
cpu	computer
windshield	wind
chalk	chalkboard
daybed	bed
hard	harddrive
backpack	back
show	sho
coin	bitcoin
kosher	kosherwine
hardwood	wood
cost	ct
table	tabletop
countertops	counter
your	tour
chair	wheelchair
cupcake	cake
veterans	va
owned	pre-owned
pneumonia	nemonia
wa	warehouse
store	superstore
database	data
lawn	lawnmowers
ubereats	uber
il	installation
steakhouse	steak
audiobook	book
malware	antimalware
food	foodloin
prepaid	pre
bookstore	book
town	townhouse
meatloaf	meat
newspaper	news
comp	computer
whiteboard	board
reader	ereader
wallpaper	paper
ray	rayben
water	wastewater
edu	edu2go
counter	countertops
counter	countertop
wear	sportswear
swimsuits	suits
hep	help
river	riverboat
flashcards	flash
earbuds	buds
leggings	jeggings
homeowners	homes
toenail	nail
testosterone	booster
swimsuits	swim
workbench	work
fl	full
handle	hand
slipcovers	covers
software	soft
any	company
class	c-class
inn	innside
cardstock	stock
bookshelf	book
shaft	driveshaft
screwdriver	driver
screwdriver	screw
work	worksheets
artwork	work
bathtubs	bath
drug	drugstore
windows10	windows
tabletop	table
homeschool	school
workwear	work
textbook	text
soil	topsoil
cheerleader	cheer
socialsecurity	security
dancewear	wear
sleeves	sleeveless
glass	plexiglass
googleflights	flights
bee	beekeeping
lip	lipstick
rava	rav4
flag	flagpole
tooth	toothpaste
fib	afib
prostate	psa
workplace	work
foot	footwear
notes	notepads
workout	work
ciprofloxacin	cipro
sweat	sweatshirt
ebooks	books
daybeds	beds
slideshow	slide
homestore	store
underwear	under
sell	cell
lampshade	lamp
snes	nes
booth	photobooth
stair	staircase
days	holidays
swimwear	wear
colostomy	ostomy
checkbook	check
upsjobs	jobs
bs	bachelors
sl	sale
door	doorbell
workout	out
carports	car
slideshow	show
dinnerware	dinner
mail	mailbox
swimwear	swim
disc	discount
gallbladder	bladder
watch	wach
sweatpants	sweat
rent	rentacar
cheer	cheerleader
activewear	wear
key	keychain
placemats	mats
you	youtube
mypillow	pillow
foxnews	news
mod	modern
keybank	bank
village	villa
obama	obamacare
stories	store
forklift	lift
tie	bowtie
bathrobes	robes
tub	hottub
cryptocurrency	currency
bandsaw	band
cancer	caner
soles	insoles
apply	app
endodontist	dentist
car	cart
childcare	child
earrings	ear
usb	usbc
snack	snackbox
dancewear	dance
bookshelves	book
geek	seatgeek
bylaws	laws
swimsuit	suit
handbook	hand
out	workout
clipboard	clip
indoor	door
week	weekend
blowers	snowblowers
carts	car
foot	football
arm	armchair
packs	packages
rabobank	bank
duct	ductwork
sailboat	boat
giveaways	give
coins	bitcoin
growing	fastgrowingtrees
optics	thinoptics
pillowcase	pillow
mrs	meyers
less	classes
pre	prepaid
waistband	waist
saucepan	pan
sig	sight
aide	ad
taxes	tx
sheets	bedsheets
over	cover
sale	dale
bread	bed
nationals	nats
showtimes	show
drugstore	store
friend	find
poles	flagpoles
locks	locksmith
hr	hiring
roommate	room
tween	teen
lines	airlines
paycheck	pay
giveaways	aways
round	rod
shade	theshadestore
toolbox	tool
vee	hyvee
beer	brewery
not	note
shorts	shirts
wk	work
carr	car
notebook	note
laws	lawsuit
del	delaware
cary	car
taillight	light
train	transportation
schooling	homeschooling
lash	eyelash
hard	hardwood
snow	snowboard
nw	new
towns	townhomes
swim	swimsuit
lampshades	lamp
obgyn	gyn
company	compant
altos	realtors
jew	jewelry
pdf	pf
chiropractor	doctor
loan	loand
blazers	trailblazers
oak	oakwood
hawks	blackhawks
counters	countertops
wall	walk
weekend	week
mouthwash	mouth
expensive	inexpensive
kickspace	space
today	td
mall	small
copy	copyright
chess	chest
exchange	change
tx	tax
horseshoe	horse
cheat	cheap
swimdress	dress
ashleyfurniturehomestore	furniture
activewear	active
ductwork	duct
stocking	sock
saber	saberforge
vyprvpn	vpn
sweatpants	sweats
printouts	print
cami	camisoles
hall	hallway
sales	aviscarsales
toenails	nails
sunroom	room
page	agency
gif	gift
bagless	bag
far	fare
sport	sportswear
youtube	tube
beehive	hive
crewneck	crew
ri	reviews
birth	birthday
bedroomfurniturediscounts	furniture
tooth	toothbrushes
classification	class
edema	lymphedema
pencil	pen
sec	section
burbank	bur
wallpapers	wall
wheelset	wheels
infertility	fertility
findcars	car
burner	aeroburner
practice	pre
butter	better
acid	facial
forklifts	fork
waterpark	water
thief	the
ste	sainte
back	backpack
mens	menswear
silver	silverware
motorhome	motor
meatballs	meat
mats	placemats
funding	crowdfunding
postcards	cards
using	advertising
cheerleading	cheer
snowmobile	snow
overhead	over
they	the
mark	mk
lampshades	shades
photographer	photo
rheumatoid	ra
nutra	nutribullet
keychains	chains
texas	tex
front	oceanfront
delhi	del
ideapad	idea
theatre	the
bipap	pap
mugshots	mug
tick	tickets
debit	debitcard
app	apply
ill	illinois
path	pathway
patent	patten
tooth	toothbrush
transportation	train
gulf	gulfport
mfg	manufacturing
closing	clothing
lit	lighted
rollaway	roll
bands	wristbands
lipstick	lip
create	crate
sv	suv
bookcases	book
mytax	tax
doorway	door
containers	can
wa	walk
being	becoming
superhero	hero
leotards	leos
touchscreen	screen
amerihealth	health
cashback	cash
wild	wildlife
topgolf	golf
countertops	counters
crank	crankshaft
inkowl	ink
spreadsheet	sheet
sheet	spreadsheet
toe	toenail
gemstone	stone
snowboards	snow
busy	business
dna	dnase
raincoat	coat
copyright	copy
donuts	dunkindonutscenter
order	preorder
mailboxes	mail
chainsaws	chains
poop	dogpoopbags
lit	light
sail	sailboat
carros	car
appstore	app
visalia	sale
inc	income
snowblowers	snow
locksmith	lock
load	loan
ok	okc
long	lounge
yardman	yard
masshealth	health
sock	stocking
mandtbank	bank
baggage	bag
site	sit
pencils	pen
horse	horseback
brook	book
webmail	mail
va	vienna
yardman	man
lounge	loungewear
sights	night
pole	flagpole
tablecloths	cloths
cloths	tablecloths
timeshare	share
multipurpose	multi
salt	saltwater
bay	by
bookcases	cases
multi	multivitamin
unsecured	secured
leash	lead
nex	nexgard
playdough	play
videos	videographers
postcard	card
foodservice	food
earplugs	ear
doormat	door
birthday	birth
waist	waistband
wwwcheap	cheap
toothbrushes	tooth
fold	bifold
quiet	quietcomfort
hong	hng
queen	mcqueen
plays	playbooks
marketwatch	market
sfax	fax
hong	hongkong
show	shoe
candlesticks	candle
basketball	basket
screwdrivers	screw
showerheads	shower
without	with
myflorida	florida
carsales	sale
yearbook	book
pigmentation	hyperpigmentation
lightshow	light
sized	oversized
bankcard	bank
nameplate	plate
candy	and
barstools	stools
teacups	tea
cpu	computers
childsupport	support
clarence	clearance
percentage	agents
baseballs	balls
fort	forth
soc	social
nightgowns	gowns
playset	play
lice	headlice
dea	deals
silverware	silver
flatbed	flat
renton	rentals
saber	lightsaber
not	notebook
lifting	weightlifting
worksheets	work
dust	dusk
harbor	harbourview
refer	refrigerator
teacups	cups
phonics	hookedonphonics
bl	bulk
hardware	hardwear
shoprite	shop
video	videographers
buttercream	butter
bead	bed
sle	sales
70d	canon70d
superbowl	bowl
biweekly	weekly
heartworm	worm
pa	practice
chairside	side
goodrich	good
helly	hellyhansen
should	shoulder
sitebuilder	site
too	tools
eats	ubereats
worldpay	pay
we	women
museum	rijksmuseum
coq10	q10
carport	car
lungcancer	cancer
myalgia	fibromyalgia
gauge	gage
freeware	free
saltwater	water
skincare	skin
mn	men
brothers	the
paystub	pay
cardinals	cards
lightweight	light
ziplock	zip
pens	penguins
garagedoorservice	service
illinois	ill
ready	reading
bayshore	shore
hover	hoverboard
matic	iceomatic
playhouse	play
pantsuit	pant
cablerail	cable
hose	hosiery
stoma	ostomy
lit	lighting
brush	toothbrush
hardwood	hard
ma	memorial
crate	create
armchair	chair
ribeye	rib
rib	ribeye
laces	shoelaces
rompers	jumpers
little	lil
helpline	help
coming	gaming
its	is
san	sand
houseplants	plants
si	sacroiliac
campo	casadecampo
night	nightgown
plywood	wood
servsafe	safe
along	long
no	nonsense
dosage	dog
paralegal	legal
cardiovascular	cardiac
ziplock	lock
headcovers	covers
too	tool
township	town
bug	ladybug
tb	tuberculosis
under	underamor
bi	bi-lo
sesamestreet	street
oilfield	oil
vols	volunteers
walk	wall
speed	speedometer
lower	flower
gostream	stream
show	shower
costs	cots
swissgear	swiss
earphone	ear
fl	foldable
villages	villa
cowgirl	cow
pellegrino	sanpellegrino
happens	app
listings	postings
inexpensive	expensive
motorcycles	motor
double	dubble
hotel	otel
seals	deals
heal	health
sunchips	chips
mymathlab	math
preorder	order
photobook	photo
shoelace	lace
worn	work
fil	fill
montpelier	vermont
skid	skidsteer
container	can
printhead	print
sailboat	sail
bedbath	bath
oilless	oil
cun	cancun
groundwater	water
glass	eyeglass
nightstand	night
door	doorstep
capable	cable
colorful	cool
vienna	wien
mid	midsize
sox	whitesox
ticketfly	ticket
mends	mens
evite	invites
lock	unlock
polyneuropathy	neuropathy
riverwalk	walk
udel	delaware
ixl	ixlcom
sandblasting	blasting
beds	bunkbeds
shuffleboard	shuffle
flaxseed	seed
consignment	mens
storybook	book
chalkboards	chalk
tight	light
sox	redsox
workstations	stations
visio	television
dealertire	tire
carseat	car
bookbag	book
wing	wingback
nonstick	non
mailbox	mail
twp	township
horseback	horse
gems	gemstone
thinoptics	optics
wheel	wheelchair
solarwinds	winds
creditcards	credit
parm	parmigiana
indy	indiana
estacion	station
unfollowers	followers
snmp	snmpwalk
southwestern	southern
ti	tickets
neckline	neck
superteacherworksheets	worksheets
covert	cover
cell	cel
mouthpiece	piece
carplay	car
ridge	bridge
saltwater	salt
bit	bitcoin
eggnog	egg
riteaid	rite
strep	streptococcus
cle	mcle
bikes	e-bikes
allwormer	dewormer
cheese	cheeseburger
ear	earbud
bookends	ends
wind	wine
ends	ands
line	a-line
agent	agen
crew	crewneck
photoshoot	photo
underbed	bed
shell	softshell
stopwatch	stop
motorcycle	moto
lav	lavatory
salle	sale
grady	ga
umichigan	michigan
chart	cart
cute	cut
carparts	car
speargun	spear
bath	bathrooms
wires	wireless
microscopes	microscopy
ga	glass
able	cable
worksheet	work
sparkplug	spark
salts	sale
flexcare	flex
long	log
strat	stratocaster
stratocaster	strat
bathfitters	bath
thing	clothing
bassshoes	shoes
eater	theater
pen	pencil
lawnmower	lawn
loveseats	seats
coolmath	math
do	dor
glide	slide
weld	jeld
gifs	gift
townhouse	town
wetting	bedwetting
fcbanking	banking
earplugs	plugs
gs	gas
thick	tick
imageclass	class
longboard	long
cpac	cpap
workmans	work
healthy	the
ironhorse	horse
per	personal
shit	shirt
train	tain
pats	patriots
capsules	caps
edi	edifact
powersports	power
dubois	bois
vacas	vacations
into	saint
they	clothes
dale	sale
vaca	vacations
endpoint	end
pillow	pillowcases
freegames	games
computers	cpu
carsales	car
chatting	dating
jeggings	leggings
bi	business
brace	bra
export	expert
marking	marketing
honey	honeymoon
tableclothsfactory	factory
dock	doc
nats	nationals
inlet	in
thrower	mower
town	tow
ale	sale
many	woman
sale	ale
cardholder	card
carriers	careers
nightmare	night
platter	plates
sat	satellite
while	file
co	carbon
disco	discount
keychain	key
ngan	phangan
bratwurst	brats
cardgames	games
oceanside	ocean
blank	bank
youtube	you
standalone	stand
homebuilders	builders
table	stable
liftgate	lift
kiddie	kids
tdbank	bank
desks	desktop
saws	bandsaws
wormer	dewormer
newspapers	news
knock	knockout
lamp	lampshade
last	las
lid	lide
renton	rent
washers	dishwashers
uti	urination
containers	cans
mercy	merch
owners	homeowners
lightweight	weight
tagout	out
wheat	what
rec	recovery
shit	shirts
stairway	stair
deli	delicatessen
bathrobe	robe
ration	raton
loans	loands
lockout	out
boom	book
spad	spay
amail	email
workwear	wear
doodles	goldendoodles
payrollservices	payroll
appt	app
bookstores	books
helpdesk	help
muckboots	muck
styles	hairstyles
film	filmmaking
oven	over
germain	saint-germain
snow	snowboarding
sabers	ultrasabers
ellijay	sell
inground	ground
upcoming	gaming
24hourwristbands	wristbands
needlepoint	needlework
nutribullet	bullet
airfares	fares
bookbag	bag
dow	window
plexiglass	glass
nameplate	name
gene	genome
marketplace	place
mean	men
mk	mark
bend	ben
boresight	bore
wineshop	wine
beetroot	beet
sale	sle
youprint	print
ra	rheumatoid
seeder	hydroseeder
multi	multifamily
accuradio	radi
honeybee	bee
lawsuit	law
newbern	new
wheelbarrows	barrows
bean	beanbag
wind	window
backhoe	back
hiring	writing
foo	football
tenderloins	tenders
morph	morphsuit
powder	power
riverwalk	river
oceaniacruises	oceania
pu	pickup
depot	dept
webb	delwebb
del	delhi
lingus	airlingus
loungewear	wear
prussia	pa
jct	junction
sugar	sugarfree
travelguard	travel
end	send
lumber	plumber
sundresses	dresses
cheaper	car
microcell	cell
campsites	sites
bodybuilder	builder
callawaypreownedgolf	preowned
scrap	scrapbooking
gravesite	grave
smartdrive	drive
tronics	electronic
efile	file
profit	non-profit
birthstone	stone
hate	hat
healthspring	spring
sunsfurniture	furniture
opentable	open
discoverstudentloans	student
arm	army
computer	comp
louis	lou
racetrack	race
honeycomb	honey
southeastern	southern
trigonometry	trig
waterbed	water
windowblinds	blinds
candlelight	candle
burlingtoncoatfactory	burlington
heap	cheap
mymail	email
boat	bareboat
count	account
eyelashes	lashes
ymail	email
wastewater	waste
mice	service
glides	sliders
bowhunting	hunting
boostmobile	mobile
phoneeasy	phone
shutdown	shut
aarpmedicaresupplement	supplement
servsafe	serve
mcdonalds	donalds
fisherman	fish
fairytale	fairy
ringworm	worm
tx	texa
riflescopes	rifle
woofer	subwoofer
spyware	spamware
roadside	side
shellcreditcard	credit
cableone	cable
handles	hand
phones	headphones
nightstands	stands
blow	blown
lb	labels
proofing	proofreading
ecard	cards
foamboard	foam
dispatch	post-dispatch
chalkboards	boards
hop	shop
shot	shop
carb	carbon
scream	howloscream
eve	events
bang	bag
bedspreads	spreads
townhall	hall
bee	beehive
dark	darth
allmodern	modern
tweens	teen
gelcoat	gel
fallout	fall
inhousepharmacy	pharmacy
resurfacing	refacing
birthstone	birth
pegboard	board
classdojo	class
cycling	bicycling
whiplash	whip
const	construction
showerhead	shower
loreal	oreal
coilover	coil
oatmeal	oat
sleepwear	sleep
voicing	invoicing
candy	can
birdhouse	bird
patriots	pat
wwwmedical	medical
fiction	nonfiction
place	palace
sitting	babysitting
northcash	cash
idrive	drive
fallsview	falls
helpdesk	desk
linn	inn
bedbugs	bed
erates	rates
luce	luca
date	datejust
edgerouter	router
do	divorce
firefighter	fighter
houseboat	boat
msds	sds
nightgown	night
guys	gus
floodplain	plain
sandstone	stone
east	eat
band	and
bodysuits	suits
trail	rail
rear	rearview
ingredients	in
lampshades	lamps
massapequa	massage
bluewater	water
way	away
lap	laptop
sa	sale
shoemakers	shoes
bioengineering	engineering
crankshaft	crank
volunteers	vols
tollway	toll
nonstick	stick
palmdale	sale
autoflex	flex
dead	deceased
eggnog	nog
puerto	pr
ecard	card
wristwatch	watch
respiratory	rt
speakerphone	speaker
floodplain	flood
skorts	shorts
snowblowers	blowers
fingerless	finger
clarita	ca
preorder	pre
superstore	store
cablerail	rail
able	table
boy	la-z-boy
centerpieces	center
glides	slides
lawman	law
litter	critter
costume	custom
beds	eds
boot	bootbarn
adderall	add
ed	education
deli	delivery
bedroom	bed
shirts	tshirts
chemo	cemo
fuel	fuelcard
uhaul	haul
dating	datingsite
smtp	smtp2go
bed	bedroom
food	foodlion
litter	litterbox
kitchen	kitchenware
ray	rayban
log	logbook
patients	pain
news	new
owned	preowned
workstation	work
fmovies	movies
clipboard	board
usaainsurance	insurance
workforce	work
ssd	ssdi
eyewash	wash
flagpoles	flag
pete	petersburg
lip	lipbalm
loads	loadboards
carecredit	credit
outerwear	outer
residential	rental
freebies	free
off	offers
birthdate	birth
speedtest	speed
floorstanding	floor
pillowcases	cases
bore	borescope
inkjets	ink
inkjets	inks
menshealth	health
driveshaft	drive
mind	mindjet
changeofaddress	address
eyewear	wear
teapots	tea
thin	thinoptics
tamu	amu
tank	tankini
wristband	wrist
colon	colonoscopy
1800flowers	flowers
std	stdcheck
uke	ukulele
disc	discectomy
headbands	bands
barnwood	wood
roadside	road
backgammon	gammon
owers	flowers
townhomes	homes
cow	cowhide
doormats	door
password	pass
drugabuse	abuse
gomovies	movies
studentloans	loans
sportsbook	sports
schedule	sch
bed	bedframe
moto	motocross
woodturning	wood
flashlight	flash
dealerships	deals
mymedicare	myaarpmedicare
landline	line
pawn	pawnshop
annualcreditreport	credit
envy	hpenvy
healthinsurance	insurance
mudjacking	jacking
phishing	antiphishing
wheat	wheatgrass
xml	xmlspy
newyork	new
pits	firepits
vari	varidesk
grubhub	grub
jackhammer	jack
ged	gedtest
good	goodlife
skidsteers	skid
scores	scoreboards
healthinsurance	health
deltadental	dental
cary	camry
grubhub	hub
wheelbarrow	barrow
handles	handlesets
whiteboards	boards
furn	furniture
shoesource	shoes
childproof	child
walk	walkway
creek	greek
lastminuteflight	minute
caregivers	givers
books	bookshop
plexiglass	plexi
transiberian	siberian
flush	flushometer
beachwear	wear
campers	campervans
stormwater	water
swingset	set
hotel	hoteis
minibus	bus
stands	tvstand
olin	online
skydiving	diving
breast	bra
main	maine
static	antistatic
steer	skidsteer
sharper	shaper
arm	armrest
servo	servomotor
flowers	floers
slotomania	slot
cardboard	card
wheatgrass	grass
blackfriday	friday
thread	tread
workplace	place
motorcycle	motor
microcentrifuge	centrifuge
maker	macker
rep	repairs
flexjobs	flex
earbuds	ear
lawrence	lawrenceville
sealing	sealcoating
banff	baniff
gps	gpsmap
pizza	pizzaria
chiro	chiropractor
loans	loansuk
voltmeter	meter
eshipping	shipping
pawn	pawnbroker
petfinder	finder
cancer	camcer
dustpan	pan
blackboard	board
do	dolar
foodservice	service
teapots	pots
wheatgrass	wheat
barnyard	barn
rec	recipes
5w40	5w
mind	mindbody
linen	line
got	govt
south	soth
neck	neckband
brick	brickwork
storefront	store
clamp	triclamp
humanadental	dental
elasticsearch	elastic
inkjetsuperstore	inkjet
padlocks	locks
hardcover	hard
class	classroom
biopharma	pharma
playstore	play
ejobs	jobs
five	fiver
flashlights	flash
wet	wetsuit
floorstanding	standing
overalls	coveralls
desktops	desk
people	peole
ct	cut
drs	drops
sear	seatgeek
fl	flyer
new	news
realestate	real
flexjobs	jobs
caring	caregiving
methyl	methylfolate
bbt	bb
pegboard	peg
dustpan	dust
dist	distributors
rail	railroad
cart	cartridge
we	website
quickbook	book
laser	laserjet
https	htp
bat	bath
got	government
rainbird	bird
carsales	sales
formalwear	formal
tense	tens
realestate	estate
beachwear	beachware
play	playground
wattstopper	stopper
pepboys	pep
denis	dentist
hairpieces	pieces
push	pushbutton
sailboats	boats
ticker	tickets
flashcards	cards
lexis	lexisnexis
loudspeaker	speaker
slumber	lumber
swings	swingsets
waterfront	water
attention	inattention
drive	driveway
playset	set
plexi	plexiglass
way	wy
freescoreonline	online
sds	sdsmax
waser	washers
insulators	installation
documentation	netdocuments
programs	sonogram
cases	vases
case	vase
tent	pent
tent	rent
tent	vent
floor	flood
123movies	movies
airlines	aerolineas
american	usa a
apple	ipad
asos	assos
bear	bare
booking buddy	bookingbuddy
bookingbuddy	booking buddy
calculator	a calculator
calendar	googlecalendar
canvas	canvashq
carecredit	car credit
carnival	shoecarnival
cellular	uscellular
cheapoair	cheap air
chrome	chromebook
costco	cost
credit	mycredit
dig	dog
espresso	nespresso
express	magexpress
face	facefx
firestix	firestick
football camp	football cap
galaxy s6 charger	galaxy s3 chargers
games	games2go
golf	golf18
groupon	coupon
hardy	hardie
icsolutions	solutions
inheritance tax	estate tax
insurance	aiginsurance
insurance	allianzinsurance
insurance	alliedinsurance
insurance	amicainsurance
insurance	autoinsurance
insurance	bikeinsurance
insurance	carinsurance
insurance	ecarinsurance
insurance	einsurance
insurance	farmersinsurance
insurance	healthinsurance
insurance	homeinsurance
insurance	lifeinsurance
insurance	njminsurance
insurance	smartinsurance
insurance	travelinsurance
insurance	usaainsurance
insurance	vaninsurance
jetnet	netjet
jetting	hydrojetting
kitchenaid	kitchen
lending	lendingtree
linkedin	linkedinjobs
lock	locker
ltd	limited
mail yahoo	yahoo local
medicaid	medicare
medicare	medicarecomplete
mexico	aeromexico
microsoft account	microsoft accounting
monster	monsterjam
officemax	office
optimum	optimal
papa john pizza	papa johns
payless	paylessrugs
propan	propane
provasil	provacyl
restore	irestore
schools	homeschool
scottrade	scottradecenter
shoes	nikeshoes
southwest	south
southwest airlines	south airlines
spectrum	spectra
speed test	internet speed test
staples	staplers
times	nytimes
travel	travelzoo
travelzoo	travel
uniformity	uniforms
usaa insurance	ussainsurance
usps tracking	usp tracking
vitamin	vitaminworld
walmart	wallart
working	coworking
zoom	xoom
cargurus	cars
canvas	bestcanvas
daily	dailies
macys	mac
dropbox	drobox
flights	netflights
flights	airflights
airlines	airfares
loans for	personal loans
top 10 electric	top 10
medicare plans	medicare advantage
home wireless security systems	wireless security system
niagara falls canada	niagara falls hotel
samsung	tvsamsung
samsung	samsungtv
samsung	gaming
dental insurance	dental plans
dental	dental plans
msccruises	cruises
toyota coupons	toyota service
abcya	abc
drive	gdrive
wayfair	wayfarer
finance	refinance
passport renewal	us passport
medi cal	medicare
work	upwork
online	line
snipping	sniffing
teleflora	teleflorist
mac	macbook
iphone nn6	iphone 6s
6	6s
fifa	fifa16
best free antivirus nn2017	best antivirus 2017
penske truck rental	penske truck
usajobs	jobs united states
verizon	version
nn365	o365
nn8	s8
bcbsil	bcbs
books	ebooks
hampton inn suites	hampton inn suites baltimore
nn7	s7
vw	volkswagen beetle
vrbo florida	florida vacation rentals
sites	websites
lighting	lightingdirect
macys	mac ys
redbox	reebok
boost mobile	mobility boost
sportswear	logosportswear
sportswear	prepsportswear
diamond ring	diamond engagement rings
diamond rings	diamond engagement rings
diamond ring	diamond engagement ring
diamond rings	diamond engagement ring
diamondrings	diamond engagement rings
engagement rings	diamond engagement rings
aengagement rings	diamond engagement ring
engagement ringa	diamond engagement ring
engagement rings	diamond engagement ring
wengagement rings	diamond engagement ring
ring	xring
ring	åring
medicare medigap plans	medicare supplement plan
medicare medigap plans	medicare supplement plans
medicare supplement companies	medicare supplement insurance companies
medicare supplement companies	medicare supplemental insurance companies
medicare supplement companies	medicare supplemental insurance company
on line	classes online
home alarm	home security
software for	management software
auto insurance	car insurance companies
criminal justice major	criminal justice degree
dodgers	los angeles dodger
dodgers	los angeles dodgers
aarp reverse mortagae information	reverse mortgage
aarp reverse mortgage information	reverse mortgage
aarp reverse mortgage information	reverse mortgages
about a reverse mortgage	reverse mortgages
about reverse mortage	reverse mortgages
about reverse mortage information	reverse mortgage
about reverse mortgage	reverse mortgages
fha reverse mortgage	reverse mortgage
about reverse mortgages for seniors	reverse mortgages
companies in	control companies
cowboys tickets	dallas cowboy ticket
cowboys tickets	dallas cowboy tickets
cowboys tickets	dallas cowboys ticket
cowboys tickets	dallas cowboys tickets
restaurant equipment	restaurant supply
medicare plans	are medicare advantage plans
medicare plans	medicare advantage plans
part d	medicare part d
t mobile phones	tmobile samsung phone
t mobile phones	tmobile samsung phones
samsung ue55hu8200	samsung ue55c8000
tgarmin gpsmap 64st	garmin gpsmap 62st
wireless dog fence	wifi dog fence
wireless dog fence	wifi dog fences
wireless dog fences	wifi dog fence
wireless dog fences	wifi dog fences
garman gpsmap 64st	garmin gpsmap 62st
garmen etrex 20	garmin etrex30
garmin 64st assesarys	garmin 62st accessories
garmin edge 820	garmin edge 800
garmin etrex 20x	garmin etrex30
garmin gpsmap 64st	garmin gpsmap 62st
garmin gpsmaps 64st	garmin gpsmap 62st
garmin nuvi 1300	garmin nuvi 1300lm
garmin nuvi 255wt	garmin nuvi 255w
gpsmap 64st	gpsmap 62st
hollister 18204	hollister 18004
nikon coolpix s8200	nikon coolpix s2800
nikon coolpix s8200	nikon coolpix s8000
nn9780060982010	9.78E+12
nn9780071782067	9.78E+12
nn9780073528205	9.78E+12
nuvi 1490	nuvi 1490t
olympus sp 820uz	olympus sp 800uz
olympus sp-820uz	olympus sp 800uz
pentair nn98209800	pentair 98209800
garmin gpsmap64st	garmin gps map 62st
garmin nuvi 57lm reviews	garmin nuvi 55lm review
garmin nuvi 57lm reviews	garmin nuvi 55lm reviews
gps map64st	gpsmap 62st
micro 820	micro 800
nn9780073398204	9.78E+12
nn98209800	98209800
olympus sp820uz	olympus sp 800uz
samsung gt i8200l	samsung gt i8000
series 9	series 7
standard 7820 800 020	standard 7820.800.020
standard 7820.800.020	standard 7820 800 020
behringer ada8200	behringer ada8000
elite 8200	elite 800
error 80048820	error80048820
forerunner 10	forerunner 410
garmin 64st	garmin 62st
garmin etrex 20	garmin etrex30
garmin nuvi 57lm	garmin nuvi 55lm
garmin nuvi 57lm review	garmin nuvi 55lm review
garmin nuvi 57lm review	garmin nuvi 55lm reviews
gps map 64st	gpsmap 62st
gt i8200	gt i8000
gt i8200l	gt i8000
nikon d8200	nikon d800
nn800 nn759 nn8203	800 759 8203
nn820 nn4800	820 4800
note n8200	note n 8000
nuvi 255wt	nuvi 255w
nuvi 57lm	nuvi 55lm
phones with	phones without
samsung gt-i8200	samsung gt i8000
samsung i8200	samsung i8000
samsung i8200m	samsung i800
samsung un55hu8200	samsung un55f8000
selphy cp820	selphy cp 800
selphy cp820	selphy cp800
sp 820uz	sp 800uz
whirlpool wtw5820sw	whirlpool wtw5800sw
7820 800 020	7820.800.020
978 0078038204	nn9780078038204
coolpix s8200	coolpix s2800
coolpix s8200 review	coolpix s2800 review
12v dc 820ma	12vdc 800ma
64st manua;l	62st manual
the note	samsung galaxy note
chase interest rates	chase mortgage rate
midsize suv	mid size cuv
sports watch	sportswatch
pocket watch	pocket swatch
sports watch	sport swatch
watch bands	swatch bands
wrist watch	wrist swatch
note 8	galaxy note 8
roofers	waterproofing
shades	shadestore
fastenal	fasteners
fastenal	fastener
fastenall	fasteners
fastenalo	fasteners
fastenals	fasteners
ultra	ultraportable
ink coupons	ink cartridges coupons
under	underarmour com
diamond	blackdiamond
cyber	cybersecurity
ultra laptop	ultrabook laptops
ultra laptop	ultraportable laptops
universities	colleges
online universities	online colleges
cold coins	buy gold coins
cold coins	gold coins
macy store	mac store
nick	nik
nick	nic
nick	nicholas
nick	nick en
nick	nicke
nick	nicko
18x24 frames	18x42 frames
18x24	18x42
amazon hp printer ink	amazon hp printer cartridges
best price printer ink	best price printer cartridges
black printer ink	black printer cartridges
brothers printer ink	brothers printer cartridges
buy ink for	ink cartridges
buy ink for a	ink cartridges
buy printer ink online	buying printer cartridges online
cannon cumputer ink	canon ink cartridge
canon pixma printer ink	canon pixma printer cartridges
canon printer ink	canon printer cartridges
canon printer ink 245 246	canon printer cartridges 245 246
canon printer ink pixma	canon printer cartridges pixma
cheap canon printer ink	cheap canon printer cartridges
cheap hp printer ink	cheap hp printer cartridges
cheap printer ink	cheap printer cartridges
computer printer ink	computer printer cartridges
costco printer ink refill	costco printer cartridges refill
dell printer ink	dell printer cartridges
dellprinter ink	dell printer cartridges
discount hp printer ink	discount hp printer cartridges
discount hp printer ink	discounts hp printer cartridges
discounted printer ink	discount printer cartridges
epson printer ink	epson printer cartridges
epson printer ink	printer cartridges epson
epson printer ink coupons	epson printer cartridges coupons
epson printer ink nn220	epson printer cartridges nn220
hewlett packard printer ink	hewlett packard printer cartridges
hp 63 printer ink	hp 63 printer cartridges
hp 8710 printer ink	hp 8710 printer cartridges
hp deskjet printer ink	hp deskjet printer cartridges
hp envy nn5530 printer ink	hp envy nn5530 printer cartridges
hp inkjet printer ink	hp deskjet printer cartridges
hp nn1510 printer ink	hp nn1510 printer cartridges
hp nn6000 printer ink	hp nn6000 printer cartridges
hp nn61 printer ink	hp nn61 printer cartridges
hp nn8710 printer ink	hp nn8710 printer cartridges
hp nn951 printer ink	hp nn951 printer cartridges
hp printer ink 564	printer cartridges hp 564
hp printer ink 564xl	hp printer cartridges 564xl
hp printer ink 61	hp printer cartridges 61
hp printer ink 63	hp printer cartridges 63
hp printer ink coupons	hp printer cartridges coupon
hp printer ink nn60	hp printer cartridges nn60
lexmark printer ink	lexmark printer cartridges
pixma printer ink	pixma printer cartridges
printer ca	printers cartridge
printer ink cheap	cheap printer cartridges
printer ink epson printers	ink cartridges epson printer
printer ink hp	hp printer cartridges
printer ink hp	printer cartridges hp
printer ink hp 564	hp printer cartridges 564
printer ink hp nn8600	printer cartridges hp nn8600
printer ink hp printer	ink cartridges hp printer
printer ink hp printer	ink cartridges printer hp
printer ink lexmark	printer cartridges lexmark
printer ink prices	printer cartridges prices
printer ink refill	printer cartridges refilling
printer ink refill	refill printer cartridges
printer ink refill kits	printer cartridges refill kits
printer ink refilling	printer cartridges refilling
printer ink refills	printer cartridges refill
printer ink refills kits	printer cartridges refill kits
printer ink staples	staples printer cartridges
refill printer ink	refilling printer cartridges
walmart printer ink	walmart printer cartridges
where buy epson ink	ink cartridges epson
hew4100 laser toner	hp 4100 toner cartridge
hp 1510 printer ink	hp 1510 printer cartridges
hp 3520 printer ink	hp 3520 printer cartridges
hp 3830 printer ink	hp 3830 printer cartridges
hp 564 printer ink	hp 564 printer cartridges
hp 6000 printer ink	hp 6000 printer cartridges
hp 61 printer ink	hp 61 printer cartridges
hp 6830 printer ink	hp 6830 printer cartridges
hp 951 printer ink	hp 951 printer cartridges
hp envy 5530 printer ink	hp envy 5530 printer cartridges
hp envy printer ink	hp envy printer cartridges
hp ink coupons	hp ink cartridges coupons
hp inkjet printer ink	hp inkjet printer cartridges
hp nn3830 printer ink	hp nn3830 printer cartridges
hp nn63 printer ink	hp nn63 printer cartridges
hp nn6600 printer ink	hp nn6600 printer cartridges
hp nn6830 printer ink	hp nn6830 printer cartridges
hp printer ink	printer cartridges hp
hp printer ink 21 22	hp printer cartridges 21 22
hp printer ink 60	hp printer cartridges 60
hp printer ink 60	printer cartridges hp 60
hp printer ink nn21 nn22	hp printer cartridges nn21 nn22
hp printer ink nn56	hp printer cartridges nn56
hp printer ink nn564	hp printer cartridges nn564
hp printer ink nn61	hp printer cartridges nn61
hp printer ink refills	hp printer cartridges refill
hp printer ink refills	hp printer cartridges refills
ink printer	printer cartridges
inkjet printer ink	ink printer cartridges
inkjet printer ink	inkjet printer cartridges
kodak printer ink	kodak printer cartridges
kodak printer ink 30	kodak printer cartridges 30
kodak printer ink nn30	kodak printer cartridges nn30
ld printer ink	ld printer cartridges
lexmark ink coupons	lexmark ink cartridges coupons
office depot printer ink	office depot printer cartridges
printer ca	printers cartridges
printer ink 61	printer cartridges 61
printer ink canon	canon printer cartridges
printer ink canon	printer cartridges canon
printer ink canon pixma	printer cartridges canon pixma
printer ink hp 564	printer cartridges hp 564
printer ink hp 61	hp printer cartridges 61
printer ink hp envy nn7640	printer cartridges hp envy nn7640
printer ink hp nn564	printer cartridges hp nn564
printer ink hp printer	ink cartridges hp printers
printer ink hp printer	printer cartridges hp printer
printer ink hp printer	printer cartridges hp printers
printer ink nn61	printer cartridges nn61
printer ink prices	printer cartridges price
printer ink recycling	printer cartridges recycle
printer ink recycling	printer cartridges recycling
printer ink walmart	printer cartridges walmart
refill printer ink	refills printer cartridges
best price printer ink	best prices printer cartridges
best prices printer ink	best price printer cartridges
best prices printer ink	best prices printer cartridges
brother printer ink	brothers printer cartridges
brothers printer ink	brother printer cartridges
buy ink epson	ink cartridges epson
canon ink coupons	canon ink cartridges coupons
canon inkjet printer ink	canon inkjet printer cartridges
canon mg2520 printer ink	canon mg5220 printer cartridges
canon mg5220 printer ink	canon mg5220 printer cartridges
canon mg5520 printer ink	canon mg5220 printer cartridges
canon printer ink nn245 nn246	canon printer cartridges nn245 nn246
canon printer ink refill	canon printer cartridges refill
canon printer ink refill	canon printer cartridges refilling
canon printer ink refill	canon printer cartridges refills
cheap printer ink	cheapest printer cartridges
cheap printer ink hp	cheap printer cartridges hp
discount printer ink	discount printer cartridges
discount printer ink	discounted printer cartridges
discounted printer ink	discounted printer cartridges
epson ink coupons	epson ink cartridges coupons
epson printer ink coupon	epson printer cartridges coupons
epson xp 410 printer ink	epson xp 410 printer cartridges
epson xp nn410 printer ink	epson xp nn410 printer cartridges
10 printer ink	10 printer cartridges
3d printer ink	3d printer cartridges
best printer ink	best printer cartridges
brother printer ink	brother printer cartridges
buy epson ink	ink cartridges epson
buy epson ink 220	ink cartridges epson 220
buy printer ink online	buy printer cartridges online
canon mg3520 printer ink	canon mg5220 printer cartridges
canon mx430 printer ink	canon mx340 printer cartridges
canon printer ink	printer cartridges canon
canon printer ink refills	canon printer cartridges refill
canon printer ink refills	canon printer cartridges refills
change printer ink	change printer cartridges
change printer ink	changing printer cartridges
cheapest printer ink	cheap printer cartridges
cheapest printer ink	cheapest printer cartridges
dell ink coupons	dell ink cartridges coupons
dell v525w printer ink	dell v515w printer cartridges
discount hp printer ink	discounted hp printer cartridges
discount printer ink	discounts printer cartridges
epson coupons ink	epson ink cartridges coupons
epson printer ink 220	epson printer cartridges 220
where buy printer ink	where buy printer cartridges
hp 4650 printer ink	hp 4650 printer cartridges
hp 5600 printer ink	hp 5600 printer cartridges
hp 6600 printer ink	hp 6600 printer cartridges
hp 8600 printer ink	hp 8600 printer cartridges
hp coupons ink	hp ink cartridges coupons
hp deskjet printer ink	hp inkjet printer cartridges
hp envy 4500 printer ink	hp envy 4500 printer cartridges
hp envy nn4500 printer ink	hp envy nn4500 printer cartridges
hp nn3520 printer ink	hp nn3520 printer cartridges
hp nn4650 printer ink	hp nn4650 printer cartridges
hp nn5600 printer ink	hp nn5600 printer cartridges
hp nn564 printer ink	hp nn564 printer cartridges
hp nn8600 printer ink	hp nn8600 printer cartridges
hp printer ink	hp printer cartridges
hp printer ink 56	hp printer cartridges 56
hp printer ink 564	hp printer cartridges 564
hp printer ink 951	hp printer cartridges 951
hp printer ink coupon	hp printer cartridges coupon
hp printer ink coupon	hp printer cartridges coupons
hp printer ink coupons	hp printer cartridges coupons
hp printer ink nn63	hp printer cartridges nn63
hp printer ink nn951	hp printer cartridges nn951
laser printer ink	laser printer cartridges
pixma canon printer ink	canon pixma printer cartridges
printer ink	printer cartridges
printer ink epson	epson printer cartridges
printer ink epson	printer cartridges epson
printer ink epson printers	ink cartridges epson printers
printer ink epson printers	ink cartridges printers epson
printer ink hp 8600	printer cartridges hp 8600
printer ink hp envy 7640	printer cartridges hp envy 7640
printer ink hp printer	hp ink cartridges printer
printer ink refill	printer cartridges refill
printer ink refill	printer cartridges refills
printer ink refill kit	printer cartridges refill kits
printer ink refilling	printer cartridges refill
printer ink refills	printer cartridges refills
refill printer ink	printer cartridges refill
refill printer ink	refill printer cartridges
refillable printer ink	refillable printer cartridges
replacement printer ink	replace printer cartridges
replacement printer ink	replacement printer cartridges
ricoh printer ink	ricoh printer cartridges
samsung printer ink	samsung printer cartridges
staples coupons ink	staples ink cartridges coupons
staples ink coupons	staples ink cartridges coupons
staples printer ink	staples printer cartridges
intravel	one travel
intravel	travel
passport renewal	us passport
truckstop	top trucks
truckstop	trucks top
truckstop	trucksop
trucksto	trucksto
truckstop	trucktop
office com	microsoft office
cowboys tickets	dallas cowboys tickets
cowboys	dallas cowboys
hyundai coupe	hyundai genesis coupe
hyundai	hyundai genesis
hyundai	keyhyundai
hyundai	myhyundai
application	app
peapod	pea in the pod
grayburn	g rayburn
grays	g rays
john gray	jong ray
jong ray	john gray
r g ray	r gray
r gray	r g ray
graynor	g raynor
grayson	g rayson
gray	g ray
travalon	www travelone com
goog e cp aor ome trave	one travel
intravel	interval
intravel	one travel
intravel	travel
on ertravel com	onetravel.com
onetravel com mx	onetravel.com
travel inc	onetravel inc
travelinc	onetravel inc
trvelone	one travel
www eonetravel com	onetravel com
www trave one	Travel-One
www travel one com	www onetravel com
travel	travelling through
travel	aatravel
travel	airtravel
travel	comtravel
travel	cubatravel
travel	for travellers
travel	gotravel
travel	itravel
travel	mytravel
travel	onetravel
travel	travelbag
travel	travelcare
travel	travelnet
travel	travelon
travel	travelshop
travel	travelzoom
travel	treval
travelon	tralevon
travelon	travel
travelon	travel on
travelon	travelin
travelon	traveling
travelon	travelone
travelon	travelong
travelon	travelonn
travelon	travelono
travelon	travelton
travel one	one travel
travel one	one traveler
travel one	one traveling
travel one	one travell
travel one	one traveller
travel one	one travels
travel one	ones travel
travel one	onetravel
travel one	ontravel
apartments for rent	forrent.com apartments
appartments for rend	forrent.com apartments
appartments for rent	forrent.com apartments
appartments for rent5	forrent.com apartments
appartments for rents	forrent.com apartments
appartments rent	forrent.com apartments
rent appartments	forrent.com apartments
for rent	forrent
for rent	www forrent
for rent	www forrent com
apartments for rent	www apartmentsforrent com
turnitin com	turn itin
turnitin com	turnit
turnitin com	turnit in
turnitin com	turn it com
turnitin com	turn it in
credit cards online	are credit card
credit cards online	are credit cards
credit cards online	credit card
credit cards online	credit card de
credit cards online	credit cards
credit cards online	it credit card
credit cards online	it credit cards
credit cards with bad credit	credit cards
credit card deals	credit cards
http www prepaid cards com	prepaid cards
visa credit card application	visa credit card
visa prepaid cards	prepaid cards
visa credit card application	visa credit card
visa credit card application	visas credit card
visa prepaid cards	prepaid cards
videos	movies
video	movie
video	movies
videos	movie
pinterest	interest
apple	appletv
accuradio	accur
docs	gdocs
realtor com	real
united states postal service	usa postal services
samsung	samsungs7
honda	hondacrv
uscis	www ins
uscis	ins
officemax	office mac
match	matchme
office	microsoftoffice
coco	cocoon
pbskids org	pb
coco	www p o co
coco	coconut
mail yahoo	yahoo map
mail yahoo	mapl yahoo
mail yahoo	meip yahoo
mail yahoo	yahoo psmi
mail yahoo	yahoo ttmi
mail yahoo	yahoo vnqi
best buy laptops	best laptops
best buy laptops	are best laptops
bmw	bmw5
babies r us	babies toy
r us	toys
water	dswaters
jeffy	jiffy
mazda	mazda3
tmobile phone deals	tmobile phones
kruger national park south africa	kruger park south africa
phone deals	phones
samsung	samsungs7
chrome browser	download chrome
chrome browser	download google chrome
lowes	glowes
roku	eroku
kitchenaid mixer	kitchen aid
kohl	koals
aesop	asop
avery	averylabels
books	booking
facebook com	book com
facebook	aface
facebook	aceb
facebook	ceboo
dog	vdog
google	browser
tube	tibe
free vpn	purevpn
facebook com	book it com
best free antivirus nn2017	best antivirus 2017
best free antivirus nn2017	best antivirus nn2017
booking	ebooking
lms	learning management
https www yahoo com	http www chase com
https www yahoo com	https www chase com
www yahoo com	www chase com
delta com	dl com
delta	dl
bcbsm	bcbs
legos	toys
www f	book com
typing	typist
delta	deltac
uggs	luggs
filehippo	hippo
v	volt
www f	book it com
shoes com	choes com
selling	sell ring
selling	sell line
selling	sell qld
selling	billing
selling	calling
apartments for rent	forrent com apartments
apartments for rent	www apartmentsforrent com
games for	bike games
games for	buy games
games for	channel games
games for	claus games
games for	club games
games for	ds games
games for	games apple
games for	games boy
games for	games four
games for	gamescom
games for	gameshop
games for	go games
games for	group games
games for	hunting games
games for	racing games
games for	squarepants games
games for	up games
games for	video games
computer laptop deals	laptop computer dell
laptop computer deals	laptops computer dell
laptop computer deals	laptop computer dell
computer deals	computer dell
computer deals	computer dills
computer deals	com deals
computer deals	com deal
boxed	boxs
coffee	cafe
durags	rags
hair	hairnets
laboratory glassware	lab glasses
siverware box	silver boxes
paper	packaging
office	officemax
durags	rags
à¹€à¸„à¸£à¸·à¹ˆà¸­à¸‡	à¹€à¸„à¸£à¸·à¹ˆà¸­à¸‡à¸„à¸£à¸±à¸§
à¹€à¸„à¸£à¸·à¹ˆà¸­à¸‡	à¹€à¸„à¸£à¸·à¹ˆà¸­à¸‡à¸ˆà¸±à¸à¸£
à¹€à¸„à¸£à¸·à¹ˆà¸­à¸‡	à¹€à¸„à¸£à¸·à¹ˆà¸­à¸‡à¸šà¸´à¸™
à¹€à¸„à¸£à¸·à¹ˆà¸­à¸‡	à¹€à¸„à¸£à¸·à¹ˆà¸­à¸‡à¸›à¸£à¸¸à¸‡
à¹€à¸„à¸£à¸·à¹ˆà¸­à¸‡	à¹€à¸„à¸£à¸·à¹ˆà¸­à¸‡à¸žà¸´à¸¡à¸žà¹Œ
à¹€à¸„à¸£à¸·à¹ˆà¸­à¸‡	à¹€à¸„à¸£à¸·à¹ˆà¸­à¸‡à¸¡à¸·à¸­
à¹€à¸„à¸£à¸·à¹ˆà¸­à¸‡	à¹€à¸„à¸£à¸·à¹ˆà¸­à¸‡à¸¢à¸™à¸•à¹Œ
à¹€à¸„à¸£à¸·à¹ˆà¸­à¸‡	à¹€à¸„à¸£à¸·à¹ˆà¸­à¸‡à¸£à¹ˆà¸­à¸™
à¹€à¸„à¸£à¸·à¹ˆà¸­à¸‡	à¹€à¸„à¸£à¸·à¹ˆà¸­à¸‡à¸ªà¸±à¸š
à¹€à¸„à¸£à¸·à¹ˆà¸­à¸‡	à¹€à¸„à¸£à¸·à¹ˆà¸­à¸‡à¹€à¸¥à¹ˆà¸™
à¹€à¸„à¸£à¸·à¹ˆà¸­à¸‡	à¹€à¸„à¸£à¸·à¹ˆà¸­à¸‡à¹à¸šà¸š